LH_VisCent_ExStr_1	LH
LH_VisCent_ExStr_2	LH
LH_VisCent_Striate_1	LH
LH_VisCent_ExStr_3	LH
LH_VisCent_ExStr_4	LH
LH_VisCent_ExStr_5	LH
LH_VisPeri_ExStrInf_1	LH
LH_VisPeri_ExStrInf_2	LH
LH_VisPeri_ExStrInf_3	LH
LH_VisPeri_StriCal_1	LH
LH_VisPeri_ExStrSup_1	LH
LH_VisPeri_ExStrSup_2	LH
LH_SomMotA_1	LH
LH_SomMotA_2	LH
LH_SomMotA_3	LH
LH_SomMotA_4	LH
LH_SomMotA_5	LH
LH_SomMotA_6	LH
LH_SomMotA_7	LH
LH_SomMotA_8	LH
LH_SomMotB_Aud_1	LH
LH_SomMotB_Aud_2	LH
LH_SomMotB_S2_1	LH
LH_SomMotB_S2_2	LH
LH_SomMotB_Aud_3	LH
LH_SomMotB_S2_3	LH
LH_SomMotB_Cent_1	LH
LH_SomMotB_Cent_2	LH
LH_DorsAttnA_TempOcc_1	LH
LH_DorsAttnA_TempOcc_2	LH
LH_DorsAttnA_ParOcc_1	LH
LH_DorsAttnA_SPL_1	LH
LH_DorsAttnA_SPL_2	LH
LH_DorsAttnA_SPL_3	LH
LH_DorsAttnB_PostC_1	LH
LH_DorsAttnB_PostC_2	LH
LH_DorsAttnB_PostC_3	LH
LH_DorsAttnB_PostC_4	LH
LH_DorsAttnB_FEF_1	LH
LH_SalVentAttnA_ParOper_1	LH
LH_SalVentAttnA_Ins_1	LH
LH_SalVentAttnA_FrOper_1	LH
LH_SalVentAttnA_FrOper_2	LH
LH_SalVentAttnA_ParMed_1	LH
LH_SalVentAttnA_FrMed_1	LH
LH_SalVentAttnA_FrMed_2	LH
LH_SalVentAttnB_IPL_1	LH
LH_SalVentAttnB_PFCl_1	LH
LH_SalVentAttnB_Ins_1	LH
LH_SalVentAttnB_PFCmp_1	LH
LH_LimbicB_OFC_1	LH
LH_LimbicB_OFC_2	LH
LH_LimbicA_TempPole_1	LH
LH_LimbicA_TempPole_2	LH
LH_LimbicA_TempPole_3	LH
LH_LimbicA_TempPole_4	LH
LH_ContA_Temp_1	LH
LH_ContA_IPS_1	LH
LH_ContA_IPS_2	LH
LH_ContA_IPS_3	LH
LH_ContA_PFCd_1	LH
LH_ContA_PFClv_1	LH
LH_ContA_PFCl_1	LH
LH_ContA_PFCl_2	LH
LH_ContA_PFCl_3	LH
LH_ContA_Cingm_1	LH
LH_ContB_Temp_1	LH
LH_ContB_IPL_1	LH
LH_ContB_PFCl_1	LH
LH_ContB_PFClv_1	LH
LH_ContB_PFClv_2	LH
LH_ContC_pCun_1	LH
LH_ContC_pCun_2	LH
LH_ContC_Cingp_1	LH
LH_DefaultA_IPL_1	LH
LH_DefaultA_PFCd_1	LH
LH_DefaultA_pCunPCC_1	LH
LH_DefaultA_pCunPCC_2	LH
LH_DefaultA_pCunPCC_3	LH
LH_DefaultA_PFCm_1	LH
LH_DefaultA_PFCm_2	LH
LH_DefaultA_PFCm_3	LH
LH_DefaultB_Temp_1	LH
LH_DefaultB_Temp_2	LH
LH_DefaultB_Temp_3	LH
LH_DefaultB_Temp_4	LH
LH_DefaultB_IPL_1	LH
LH_DefaultB_PFCd_1	LH
LH_DefaultB_PFCd_2	LH
LH_DefaultB_PFCd_3	LH
LH_DefaultB_PFCd_4	LH
LH_DefaultB_PFCv_1	LH
LH_DefaultB_PFCv_2	LH
LH_DefaultB_PFCv_3	LH
LH_DefaultB_PFCv_4	LH
LH_DefaultC_IPL_1	LH
LH_DefaultC_Rsp_1	LH
LH_DefaultC_PHC_1	LH
LH_TempPar_1	LH
LH_TempPar_2	LH
RH_VisCent_ExStr_1	RH
RH_VisCent_ExStr_2	RH
RH_VisCent_Striate_1	RH
RH_VisCent_ExStr_3	RH
RH_VisCent_ExStr_4	RH
RH_VisCent_ExStr_5	RH
RH_VisPeri_ExStrInf_1	RH
RH_VisPeri_ExStrInf_2	RH
RH_VisPeri_StriCal_1	RH
RH_VisPeri_ExStrSup_1	RH
RH_VisPeri_ExStrSup_2	RH
RH_VisPeri_ExStrSup_3	RH
RH_SomMotA_1	RH
RH_SomMotA_2	RH
RH_SomMotA_3	RH
RH_SomMotA_4	RH
RH_SomMotA_5	RH
RH_SomMotA_6	RH
RH_SomMotA_7	RH
RH_SomMotA_8	RH
RH_SomMotA_9	RH
RH_SomMotA_10	RH
RH_SomMotA_11	RH
RH_SomMotB_Aud_1	RH
RH_SomMotB_Aud_2	RH
RH_SomMotB_S2_1	RH
RH_SomMotB_S2_2	RH
RH_SomMotB_S2_3	RH
RH_SomMotB_S2_4	RH
RH_SomMotB_Cent_1	RH
RH_DorsAttnA_TempOcc_1	RH
RH_DorsAttnA_ParOcc_1	RH
RH_DorsAttnA_SPL_1	RH
RH_DorsAttnA_SPL_2	RH
RH_DorsAttnA_SPL_3	RH
RH_DorsAttnA_SPL_4	RH
RH_DorsAttnB_PostC_1	RH
RH_DorsAttnB_PostC_2	RH
RH_DorsAttnB_PostC_3	RH
RH_DorsAttnB_PostC_4	RH
RH_DorsAttnB_FEF_1	RH
RH_SalVentAttnA_ParOper_1	RH
RH_SalVentAttnA_PrC_1	RH
RH_SalVentAttnA_Ins_1	RH
RH_SalVentAttnA_Ins_2	RH
RH_SalVentAttnA_FrOper_1	RH
RH_SalVentAttnA_FrMed_1	RH
RH_SalVentAttnA_ParMed_1	RH
RH_SalVentAttnA_ParMed_2	RH
RH_SalVentAttnA_FrMed_2	RH
RH_SalVentAttnB_IPL_1	RH
RH_SalVentAttnB_PFClv_1	RH
RH_SalVentAttnB_PFCl_1	RH
RH_SalVentAttnB_Ins_1	RH
RH_SalVentAttnB_Ins_2	RH
RH_SalVentAttnB_PFCmp_1	RH
RH_LimbicB_OFC_1	RH
RH_LimbicB_OFC_2	RH
RH_LimbicB_OFC_3	RH
RH_LimbicB_OFC_4	RH
RH_LimbicA_TempPole_1	RH
RH_LimbicA_TempPole_2	RH
RH_LimbicA_TempPole_3	RH
RH_LimbicA_TempPole_4	RH
RH_ContA_IPS_1	RH
RH_ContA_IPS_2	RH
RH_ContA_PFCd_1	RH
RH_ContA_PFCl_1	RH
RH_ContA_PFCl_2	RH
RH_ContA_Cingm_1	RH
RH_ContB_Temp_1	RH
RH_ContB_Temp_2	RH
RH_ContB_IPL_1	RH
RH_ContB_IPL_2	RH
RH_ContB_PFCld_1	RH
RH_ContB_PFCld_2	RH
RH_ContB_PFClv_1	RH
RH_ContB_PFClv_2	RH
RH_ContB_PFCmp_1	RH
RH_ContB_PFCld_3	RH
RH_ContC_pCun_1	RH
RH_ContC_pCun_2	RH
RH_ContC_Cingp_1	RH
RH_DefaultA_IPL_1	RH
RH_DefaultA_PFCd_1	RH
RH_DefaultA_pCunPCC_1	RH
RH_DefaultA_PFCm_1	RH
RH_DefaultA_PFCm_2	RH
RH_DefaultA_PFCm_3	RH
RH_DefaultB_Temp_1	RH
RH_DefaultB_AntTemp_1	RH
RH_DefaultB_PFCd_1	RH
RH_DefaultB_PFCv_1	RH
RH_DefaultC_IPL_1	RH
RH_DefaultC_Rsp_1	RH
RH_DefaultC_PHC_1	RH
RH_TempPar_1	RH
RH_TempPar_2	RH
RH_TempPar_3	RH
RH_TempPar_4	RH